12
23
02 02 02 02 02 02 02 02 02 02 02 02 00 02 02 02 02 02 02 02 02 02 02
02 00 00 00 00 00 00 00 00 00 00 00 00 00 00 00 00 00 00 00 00 00 02
02 00 00 00 00 00 00 00 00 00 00 00 03 00 00 00 00 00 00 00 00 00 02
02 00 00 00 00 00 00 00 00 00 03 00 00 00 00 00 00 00 00 00 00 00 02
02 00 00 00 00 00 00 00 00 00 00 00 00 00 00 00 00 00 00 00 00 00 02
02 00 00 00 00 00 00 00 03 00 00 00 00 00 00 03 00 00 00 00 00 00 02
02 00 00 00 00 00 00 00 00 00 00 03 00 00 00 00 00 00 00 00 00 00 02
02 00 00 00 00 00 00 00 00 00 00 00 00 00 00 00 00 00 00 00 01 01 02
02 00 00 00 00 00 00 00 00 00 00 00 00 00 00 01 00 00 00 00 00 00 02
02 00 00 00 00 01 01 00 00 00 00 00 00 03 00 02 00 00 00 00 00 00 02
02 00 00 00 00 00 00 00 00 00 00 00 00 00 00 02 00 00 00 00 00 00 02
02 01 01 04 04 04 04 04 04 04 04 01 01 01 01 02 04 04 04 04 04 04 02